{
  "bots":[
    {"x":1,"y":3},
    {"x":1,"y":11}
  ],
  "map":[
    [2, 2, 2],
    [2, 0, 2],
    [2, 2, 2],
    [4, 2, 4],
    [4, 4, 4],
    [4, 5, 4],
    [3, 5, 3],
    [3, 1, 3],
    [3, 5, 3],
    [4, 5, 4],
    [4, 4, 4],
    [4, 2, 4],
    [2, 2, 2],
    [2, 0, 2],
    [2, 2, 2]
  ]
}
