{
  "map":[
    [3, 3, 3, 3, 3, 3],
    [3, 2, 4, 9, 2, 3],
    [3, 9, 2, 2, 4, 3],
    [3, 4, 2, 2, 9, 3],
    [3, 2, 9, 4, 2, 3],
    [3, 3, 3, 3, 3, 3]
  ]
}
